11111111111111111111
10000001100000000001
10000000100000100111
10001100100100100001
11000100100111111111
11100100100000000011
10100000100100111011
10000000100100000011
10001111100100000001
10101010000100001001
10101000011100111001
10101100001000111001
11100000001000001001
10000000000000000001
10001111100000000011
10001000100000000011
10001011111111111011
10001000000000000011
10001011111111111001
11111111111111111111