11111111111111111111111111
10010010010010101010010111
11010110110101010101111111
10010010010101010100001111
10111011011100011100000111
10000000010010111000111111
11011110110011111001111111
10001100010011110011111111
10100001010011100111100111
10111011011100011100000111
10000000010010111000111111
11011110110011111001111111
10001100010011110011111111
10100001010011100111100111
10111011011100011100000111
10000000010010111000111111
11011110110011111001111111
10001100010011110011111111
10100001010011100111100111
11111111111111111111111111