1111111111
1001001001
1101011011
1001001001
1011101101
1000000001
1101111011
1000110001
1010000101
1111111111