11111111111111111111111111
10000001000000000100000001
10000001000000000100000001
10000001000000000100000001
10000001000000000100000001
10000001000000000100000001
10000001000000000100000001
10000001000000000100000001
10000000000000000100000001
10000000000000000100000001
10000000000000000100000001
10000000000000000000000001
10000000000000000000000001
10000000000000000000000001
10000000000000000000000001
10000000000110000000000001
10000000000100000000000001
10000000000100000000000001
10000000000100000000000011
11111111111111111111111111